R 1920 1080
NO ./images/kita.xpm
SO ./images/minami.xpm
WE ./images/nishi.xpm
EA ./images/higashi.xpm

S ./images/eagle.xpm
F 220,10,0
C 225,30,0




        1111111111111111111111111
        1000000000110000000000001
        1011000001110000002000001
        1001000000000000000000001
111111111011000001110000000000001
100000000011000001110111111111111
11110111111111011100000010201
11110111111111011101210010001
11000000110101011100000010001
10002000000000001100200010201
10000000000000001121010010001
11000001110101011111011110N0111
11110111 1110101 101111010001
11111111 1111111 111111111111


