R 540 320
NO ./images/kita.xpm
SO ./images/minami.xpm
WE ./images/nishi.xpm
EA ./images/higashi.xpm

S ./images/eagle.xpm
F 220,10,0
C 225,30,0




         11111111111111111111111
        100200000011002000N0000011
        10110020011100000020000011
        1001000000000000000000021
 11111111011000001110000000000001
10000000001100000111011111111111
 1110111111111010100000010201
11110111111111010001210010001
 1000000110101011100000010001
10002000000000001100200010201
10000000000000001121010000001
1100000111010101111101111000111
  110111 1110101 101111010001
111 1    111111   1111111111


